{
  "Map": [
    [5, 5, 5, 5, 5, 5, 5, 5, 5, 5, 5, 5, 5, 5, 5, 5, 5, 5, 5, 5],
    [5, 4, 2, 2, 2, 5, 2, 2, 2, 2, 2, 2, 2, 2, 5, 2, 2, 2, 2, 5],
    [5, 2, 5, 5, 2, 5, 2, 5, 5, 5, 5, 5, 5, 2, 5, 2, 5, 5, 2, 5],
    [5, 2, 5, 2, 2, 2, 2, 2, 2, 2, 2, 2, 2, 2, 2, 2, 2, 5, 2, 5],
    [5, 2, 5, 2, 5, 5, 2, 5, 5, 2, 2, 5, 5, 2, 5, 5, 2, 5, 2, 5],
    [5, 2, 2, 2, 2, 2, 2, 5, 3, 3, 3, 3, 5, 2, 2, 2, 2, 2, 2, 5],
    [5, 2, 5, 2, 5, 5, 2, 5, 5, 5, 5, 5, 5, 2, 5, 5, 2, 5, 2, 5],
    [5, 2, 5, 2, 2, 2, 2, 2, 2, 2, 2, 2, 2, 2, 2, 2, 2, 5, 2, 5],
    [5, 2, 5, 5, 2, 5, 2, 5, 5, 5, 5, 5, 5, 2, 5, 2, 5, 5, 2, 5],
    [5, 2, 2, 2, 2, 5, 2, 2, 2, 1, 2, 2, 2, 2, 5, 2, 2, 2, 4, 5],
    [5, 5, 5, 5, 5, 5, 5, 5, 5, 5, 5, 5, 5, 5, 5, 5, 5, 5, 5, 5],
    [6, 6, 6, 6, 6, 6, 6, 6, 6, 6, 6, 6, 6, 6, 6, 6, 6, 6, 6, 6]
  ]
}